1111111111111111110s0111111111111111111
111111111111111111000111111111111111111
111111111111111111000111111111111111111
111111111111111111000111111111111111111
111111111111111111000111111111111111111
111111111111111111000111111111111111111
111111111111111111000111111111111111111
111111111111111111000111111111111111111
111111111111111111000111111111111111111
111111111111111111000111111111111111111
111111111111111111000111111111111111111
111111111111111111000111111111111111111
111111111111111111000111111111111111111
111111111111111111000111111111111111111
111111111111111111000111111111111000000
111111000000000000000000000000000000000
111111000000000000000000000000000000000
111111000000000000000000000000000000000
111111000000000000000000000000000000000
111111000111111111111111111111000000000
111111000111111111111111111111000000000
111111000111111111111111111111000000000
111111000111111111111111111111000000000
111111000111111111111111111111000000000
111111000111111111111111111111000000000
111111000111111111111111111111000000000
111111000111111111111111111111000001111
111111000111111111111111111111000001111
111111000111111111111111111111000001111
1111110e011111111111111111111100e001111