111111111111111111111111111111100s0111111
1111111111111111111111111111110000111111
1111111111111111111111111111110000111111
1111111111111111111111111111110000111111
1111111111111111111111111111110000111111
1111111111111111111111111111110000111111
1100000000000000000000111111110000111111
1100000000000000000000111111110000111111
1100000000000000000000111111110000111111
1100000000000000000000111111110000000000
1100001111111111110000111111110000000000
1100001111111111110000111111110000000000
1100001111111111110000111111110000000000
1100001111111111110000111111110000000000
1100000000000011110000111111110000000000
1100000000000011110000111111110000000000
1100000000000011110000111111110000000000
1100000000000011110000111111110000000000i
1111111111000011110000111111110000000000
1111111111000011110000000000000000000000
1111111111000011110000000000000000000000
1111111111000011110000000000000000000000
1111111111000011110000000000000000111111
1100000000000011111111111111111111111111
1100000000000011111111111111111111111111
1100000000000011111111111111111111111111
1100001111111111111111111111111111111111
1100001111111111111111111111111111111111
110e001111111111111111111111111111111111
1111111111111111111111111111111111111111