1111111111111111111111111111111111111111
1111111111111111111111111111111111111111
1111111111111111111111111111111111111111
1111111111111111111111111111111111111111
1111111111111111111111111111111111111111
s000000000000000000000000000000000111111
0000000000000000000000000000000000111111
0000000000000000000000000000000000111111
0000000000000000000000000000000000111111
1111111111111111111111111111111000111111
1111111111111111111111111111111000111111
1111111111111111111111111111111000000000
1111111111111111111111111111111000000000
1111111111111111111111111111111000000000
1111000000000000000000000000000000000000
1111000000000000000000000000000000000000
1111000000000000000000000000000000000000
1111000000000000000000000000000000000000
1111000011111111111111111111111111000000
1111000011111111111111111111111111000000
1111000011111111111111111111111111000000
1111000011111111111111111111111111000000
1111000011111111111111111111111111000000
1111000011111111111111111111111111111111
1111000000000000000000000000000000000011
1111000000000000000000000000000000000011
1111000000000000000000000000000000000011
1111111111111111111111111111111111000011
1111111111111111111111111111111111000011
111111111111111111111111111111111100e011